5 8
0 0
4 7
S......c
........
....#...
c.......
.......G