6 8
0 0
5 7
S1.....c
199999..
1......9
1......9
1......9
c111111G